111111111111111111111111111111111111111111111111111111111111111111111111111
1P0000000100000000000000000000000000000000000000000000000000000000000000001
100000000100000000000000000000000000000000000000000000000000000000000000001
100000000100000000000000000000000000000000000000000000000000000000000000001
100000000100000000000000000000000000000000000000000000000000000000000000CE1
100000000100000000000000000000000000000000000000000000000000000000000000011
10000M000100000000000000000000000000000000000000000000000000000000000000001
1M0000000111111111111111100000000000000000000000000000000000000000000000001
100000000000000000000000000000000M00000000000000000000000000000000000000001
111111111111111111111111111111111111111111111111111111111111111111111111111
