1111111111111
10010000000C1
1000011111001
1P01M1EC00011
1111111111111
