111111111111111111
10C00000CC00000001
101000001100000101
101100001100001101
101010001100010101
101011001100110101
101001001100100101
101001001100100101
101011001100110101
101010011110010101
101110010010011101
1P1011010010110101
101001110011100101
101000101101000101
101000101101000101
101111111111111101
100000101101000001
100000011110000C01
100000001100000C01
11000000000000E011
111111111111111111
